1000132221
2032222310
1200313012
1233100223
1333101130
3020230310
1311300322
0001202101
0333223112
0222322122
