1032300212
3110022320
0323211321
2013211311
1310313022
0001112123
1133031010
0312100310
2123010220
3321130120
