3221130223
0112023011
3312210010
2021310100
3122020201
2333330222
0300013102
1021333210
0110222330
1222102022
