3131322003
2303111330
0030023133
1101322210
0233023022
3213113123
1230312031
3230010330
0313030323
2121213332
