23300302130223031132
01200330212203303102
02203123212312032200
11003222120010032122
30301323232331202021
23200313302302300102
32222111002110031120
32030211300013022222
12233031222332212222
33030121022303302131
32030333030102022212
20213031303310230223
12202000332301333012
33210111113003132223
20023330310212320003
30103122030323000200
03232221321321033001
31010301012033100330
01032121213221322203
10222133311200200113
