2121332013
0212311223
1213033031
0212122112
1330030023
0202223113
2331010210
1020030311
1230102023
2022312200
